*************************************************************************************************************************************
*************************************************************************************************************************************
****..........***********************************************************************************************************************
****..........***********************************************************************************************************************
****..........******.......**********************************************************************************************************
****..........******.......******...........*****************************************************************************************
****..........******.......******...........*****************************************************************************************
****..........******.......******...........*****************************************************************************************
****..........******........................*****************************************************************************************
********.***********.......******...........*****************************************************************************************
********.*************.**********...........*****************************************************************************************
********.*************.*************.************************************************************************************************
********.*************.*************.************************************************************************************************
********.*************.*************.************************************************************************************************
******.......******.......**********.************************************************************************************************
******....................****........*****...........*******************************************************************************
******.......******.......****........*****...........*****************************************************************..........****
******.......******.......****........*****...........*****************************************************************..........****
*******.***********.......****........................**************************************.....................******..........****
*******.***********.......****........**********.*************************...........*******.....................................****
*******.****************************************.*************************...........*******.....................******..........****
*******.****************************************.*************************...........*******.**************************..........****
*******.****************************************.****************************....***********.**************************..........****
***.........************************************.****************************....***********.****************************************
***.........*************************..............******...........*********....***********.****************************************
***...........................*******..............******...........*********....***********.****************************************
***.........*******...........*******..............******...........******.....................**************************************
***.........*******...........*******..........................................................**************************************
***.........*******................................******...........******.....................**************************************
*******************...........*******..............******...........******.....................**************************************
*************************************..............******...........******.....................**************************************
**************************************************************.**********************************************************************
**************************************************************.**********************************************************************
**************************************************************.**********************************************************************
**************************************************************.**********************************************************************
**************************************************************.**********************************************************************
**************************************************************.**********************************************************************
**************************************************************.**********************************************************************
**************************************************************.**********************************************************************
**************************************************************.*********************************************************...........**
**************************************************************.*********************************************************...........**
**************************************************************.*********************************************************...........**
****************************************************....................************************************************...........**
***********************************..............................................***************************************...........**
***********************************.............*****...................****........************************************...........**
***********************************.............*******...............*******....*....***************************************.*******
************..........*************.............*********...........**********..........*************************************.*******
************..........******....................***********.......*************.........*************************************.*******
************..........******....................***********.*...*.*************...****...************************************.*******
************....................................***********.......**************...****......********************************.*******
************..........******....................***********.*...*.**************.........*........***************************.*******
************..........******....................***********.......****************....****......*...*************************.*******
************..........*************.............***********.*...*.******************.......****.***..************************.*******
***********************************.............***********.......*********************.......*......************************.*******
***********************************.............***********.*...*.**************************....*..*.************************.*******
***********************************.............***********.......***************************........************************.*******
**********************************************************************************************.*..**...**********************.*******
**********************************************************************************************.................................******
**********************************************************************************************....**....**....****...**.......*******
***********************************************************************************************..**.....**....****....**......*******
***********************************************************************************************............**................********
************************************************************************************************...........**..*.......*.....********
*************************************************************************************************........................************
*************************************************************************************************************************************
*************************************************************************************************************************************