*************************************************************************************************************************************              
*************************************************************************************************************************************              
****..........***********************************************************************************************************************              
****..........**********.************************************************************************************************************              
****..........******.......*************.********************************************************************************************              
****...........*****.......******...........*****************************************************************************************              
****..........******.......******...........*****************************************************************************************              
****..........*****........******...........*****************************************************************************************              
****..........******.........................****************************************************************************************              
********.***********.......******...........*****************************************************************************************              
********.*************.**********...........*****************************************************************************************              
********.*************.*************.************************************************************************************************              
********.*************.*************.************************************************************************************************              
********.*************.*************.************************************************************************************************              
******.......******.......**********.***************.********************************************************************************              
******....................****........*****...........*******************************************************************************     ****.****
*****........******........***........*****............****************************************************************..........****     *.......*
******.......******.......****........*****...........*****************************************************************..........****     *.......*
*******.***********.......****........................**************************************.....................******..........****     *.*...*.*
*******.***********.......****........**********.*************************...........*******.....................................****     *.......*
*******.*************.**********.***************.*************************...........*******.....................******..........****     *.*...*.*
*******.****************************************.*************************...........*******.**************************..........****     *.......*
*******.****************************************.****************************....***********.**************************..........****     *.*...*.*
***.........************************************.****************************....***********.****************************************     *.......*
***.........**************.**********..............******...........*********....***********.****************************************     *.*...*.*
**............................*******..............******...........*********....***********.****************************************     *.......*
***.........*******...........*******..............******...........******.....................**************************************     *.*...*.*
***.........*******...........*******..........................................................**************************************     *.......*
***.........*******................................******...........******.....................**************************************     *.*...*.*
******.************...........*******..............******...........******.....................**************************************     *.......*
**********************.**************..............******...........******.....................**************************************     *.*...*.*
**************************************************************.**********************************************************************     *.......*
**************************************************************.**********************************************************************     *.*...*.*
**************************************************************.**********************************************************************     *.......*
**************************************************************.**********************************************************************     *.*...*.*
**************************************************************.**********************************************************************     *.......*
**************************************************************.**********************************************************************     *.*...*.*
**************************************************************.**********************************************************************     *.......*
**************************************************************.**********************************************************************     *.*...*.*
**************************************************************.*********************************************************...........**     *.......*
**************************************************************.*********************************************************...........**     *.*...*.*
**************************************************************.*********************************************************...........**     *.......*
****************************************************....................************************************************...........**     *.*...*.*
***********************************..............................................***************************************...........**     *.......*
***********************************.............****....................****........************************************...........**     *.*...*.*
***********************************.............*******...............*******.........***************************************.*******     *.......*
************..........*************.............*********...........**********..........*************************************.*******     *.*...*.*
************..........******....................***********.......*************.........*************************************.*******     *.......*
************..........******....................***********.*...*.*************..........************************************.*******     *.*...*.*
************....................................***********.......**************.............********************************.*******     *.......*
************..........******....................***********.*...*.**************..................***************************.*******     *.*...*.*
************..........******....................***********.......****************..................*************************.*******     *.......*
************..........*************.............***********.*...*.******************.................************************.*******     *.*...*.*
***********************************.............***********.......*********************..............************************.*******     *.......*
***********************************.............***********.*...*.*************************..........************************.*******     *.*...*.*
***********************************.............***********.......***************************........************************.*******     *.......*
**************************************************************.*******************************.........**********************.*******     *.*...*.*
**********************************************************************************************.................................******     *.......*
**********************************************************************************************................................*******     *.*...*.*
***********************************************************************************************...............................*******     *.......*
***********************************************************************************************..............................********     *.*...*.*
************************************************************************************************.............................********     *.......*
*************************************************************************************************........................************     *.*...*.*
*************************************************************************************************************************************     *.......*
*************************************************************************************************************************************     *********