                                                                                                                                     
   ************                                                                                                                      
   *..........*                                                                                                                      
   *..........*    *********                                                                                                         
   *..........*    *.......*    *************                                                                                        
   *..........*    *.......*    *...........*                                                                                        
   *..........*    *.......*    *...........*                                                                                        
   *..........*    *.......******...........*                                                                                        
   *..........*    *........................*                                                                                        
   *****.******    *.......******...........*                                                                                        
       *.*         ***.*****    *...........*                                                                                        
       *.*           *.*        ****.********                                                                                        
       *.*           *.*           *.*                                                                                               
     ***.*****    ****.****        *.*                                                                                               
     *.......******.......*  *******.**   *************                                                                              
     *....................*  *........*   *...........*                                                               ************   
     *.......******.......*  *........*   *...........*                                                               *..........*   
     *.......*    *.......*  *........*****...........*                                    ***********************    *..........*   
     **.******    *.......*  *........................*                  *************     *.....................******..........*   
      *.*         *.......*  *........**********.******                  *...........*     *.....................................*   
      *.*         *********  **********        *.*                       *...........*     *.....................******..........*   
      *.*                                      *.*                       *...........*     *.*********************    *..........*   
  *****.*****                                  *.*                       ****....*****     *.*                        *..........*   
  *.........*                       ************.***    *************       *....*         *.*                        ************   
  *.........*******************     *..............*    *...........*       *....*         *.*                                       
  *...........................*     *..............*    *...........*    ****....***********.***                                     
  *.........*******...........*     *..............******...........******.....................*                                     
  *.........*     *...........*******..........................................................*                                     
  *.........*     *................................******...........******.....................*                                     
  ***********     *...........*******..............*    *...........*    *.....................*                                     
                  *************     *..............*    *...........*    *.....................*                                     
                                    ****************    ******.******    ***********************                                     
                                                             *.*                                                                     
                                                             *.*                                                                     
                                                             *.*                                                                     
                                                             *.*                                                                     
                                                             *.*                                                                     
                                                             *.*                                                                     
                                                             *.*                                                       ************* 
                                                             *.*                                                       *...........* 
                                                             *.*                                                       *...........* 
                                                    **********.**********                                              *...........* 
                                  ******************....................******************                             *...........* 
                                  *..............................................*********                             *...........* 
                                  *.............*****...................****........******                             *...........* 
           ************           *.............*   ***...............***   *.........****                             ******.****** 
           *..........*    ********.............*   *****...........*****   **..........**                                  *.*      
           *..........*    *....................*   *******.......*******   ***.........***************                     *.*      
           *..........******....................*         *.*...*.*         ***..........**************                     *.*      
           *....................................*         *.......*         ****.............**********                     *.*      
           *..........******....................*         *.*...*.*         ****..................*****                     *.*      
           *..........*    *....................*         *.......*         ******..................***                     *.*      
           *..........*    ********.............*         *.*...*.*         ********.................**                     *.*      
           ************           *.............*         *.......*         ***********..............**                     *.*      
                                  *.............*         *.*...*.*         ****************.........******************     *.*      
                                  *.............*         *.......*         *****************........******************     *.*      
                                  ***************         *********                        ***.........**********************.*******
                                                                                           ***.................................******
                                                                                           ***................................*******
                                                                                           ****...............................*******
                                                                                           ****..............................********
                                                                                           *****.............................********
                                                                                           ******........................************
                                                                                           ******************************************
                                                                                           ******************************************