                                                                                                                                                                             
   ************                                                                                                                                                              
   *..........*                                                                                                                                                              
   *..........*    *****.***                                                                                                                                                 
   *..........*    ****....*    ********.****                                                                                                                                
   *...........    ***.....*    *...........*                                                                                                                                
   *..........*    ***.....*    *.....*.....*                                                                                                                                
   *..........*    ........******.....*.....*                                                                                                                                
   *..........*    *.........................                                                                                                                                
   *****.******    *.....********......***..*                                                                                                                                
       *.*         ***.*****    *...........*                                                                                                                                
       *.*           *.*        ****.********                                                                                                                                
       *.*           *.*           *.*                                                                                                                                       
     ***.*****    ****.****        *.*                                                                                                                                       
     *.....*********......*  *******.**   **********.**                                                                                                                      
     *....................*  *........*   *...........*                                                               ************        ****.****      *********..*********
     .......*******....*...  *.....*..*   *....***.....                                                               *..........*        *.......*      **................**
     *....****    **..*...*  *.....*..*****......**...*                                    ***********************    *..........*        *.......*      **....;;....;;....**
     **.******    **......*  *........................*                  *************     *.....................******..........*        *.*...*.*      **...;!!;;;;!!;...**
      *.*         ***.....*  *........**********.******                  *...........*     *.....................................*        *.......*      **...;!!;;;;!!;...**
      *.*         ***.*****  ***.******        *.*                       *...........*     *.....................******..........*        *.*...*.*      **...;;;;;;;;;;...**
      *.*                                      *.*                       *...........*     *.*********************    *..........*        *.......*      **..;;;;;;;;;;;;..**
  *****.*****                                  *.*                       ****....*****     *.*                        *..........*        *.*...*.*      **.;!!;;;;;;;;!!;.**
  ***.....***                       ************.***    *************       *....*         *.*                        ************        *.......*      **.;!!;;;;;;;;!!;.**
  *........***************.****     *..............*    *...........*       *....*         *.*                                            *.*...*.*      **..;;;;;;;;;;;;..**
  ...................*........*     *.........*....*    *...........*    ****....***********.***                                          *.......*      **...;!;;;;;;!;...**
  *.........*******.......*...*     *..............******...........******.....................*                                          *.*...*.*      **....;;;;;;;;....**
  *.......***     *...........*******.......*..................................................*                                          *.......*      *****..;!;;!;..*****
  *.....*****     *.*..............................******...........******.....................*                                          *.*...*.*      *****..;;;;;;..*****
  ****.******     *...........*******..*.........*.*    *...........*    *.....................*                                          *.......*      *****..;!;;!;..*****
                  ****.********     *..............*    *...........*    *.....................*                                          *.*...*.*      *****...;..;...*****
                                    ****************    ******.******    ***********************                                          *.......*      *******......*******
                                                             *.*                                                                          *.*...*.*      *******......*******
                                                             *.*                                                                          *.......*      *********..*********
                                                             *.*                                                                          *.*...*.*      *********..*********
                                                             *.*                                                                          *.......*      *********..*********
                                                             *.*                                                                          *.*...*.*                          
                                                             *.*                                                                          *.......*                          
                                                             *.*                                                       *************      *.*...*.*                          
                                                             *.*                                                       *...........*      *.......*                          
                                                             *.*                                                       *...........*      *.*...*.*                          
                                                    **********.**********                                              *...........*      *.......*                          
                                  ******************....................******************                             *...........*      *.*...*.*                          
                                  *..............................................*********                             *...........*      *.......*                          
                                  *.............****....................****........******                             *...........*      *.*...*.*                          
           ************           *.............*   ***...............***   *.........****                             ******.******      *.......*                          
           *..........*    ********.............*   *****...........*****   **..........**                                  *.*           *.*...*.*                          
           *..........*    *....................*   *******.......*******   ***.........***************                     *.*           *.......*                          
           *..........******....................*         *.*...*.*         ***..........**************                     *.*           *.*...*.*                          
           *....................................*         *.......*         ****.............**********                     *.*           *.......*                          
           *..........******....................*         *.*...*.*         ****..................*****                     *.*           *.*...*.*                          
           *..........*    *....................*         *.......*         ******..................***                     *.*           *.......*                          
           *..........*    ********.............*         *.*...*.*         ********.................**                     *.*           *.*...*.*                          
           ************           *.............*         *.......*         ***********..............**                     *.*           *.......*                          
                                  *.............*         *.*...*.*         ***************..........******************     *.*           *.*...*.*                          
                                  *.............*         *.......*         *****************........******************     *.*           *.......*                          
                                  ***************         ****.****                        ***.........**********************.*******     *.*...*.*                          
                                                                                           ***.................................******     *.......*                          
                                                                                           ***................................*******     *.*...*.*                          
                                                                                           ****...............................*******     *.......*                          
                                                                                           ****..............................********     *.*...*.*                          
                                                                                           *****.............................********     *.......*                          
                                                                                           ******........................************     *.*...*.*                          
                                                                                           ******************************************     *.......*                          
                                                                                           ******************************************     *********                          