*************************************************************************************************************************************                                        
*************************************************************************************************************************************                                        
****..........***********************************************************************************************************************                                        
****..........**********.************************************************************************************************************                                        
****..........*********....*************.********************************************************************************************                                        
****...........*******.....******...........*****************************************************************************************                                        
****..........********.....******.....*.....*****************************************************************************************                                        
****..........*****........******.....*.....*****************************************************************************************                                        
****..........******.........................****************************************************************************************                                        
********.***********.....********......***..*****************************************************************************************                                        
********.*************.**********...........*****************************************************************************************                                        
********.*************.*************.************************************************************************************************                                        
********.*************.*************.************************************************************************************************                                        
********.*************.*************.************************************************************************************************                                        
******.....*********......**********.***************.********************************************************************************                                        
******....................****........*****...........*******************************************************************************     ****.****      *********..*********
*****.......*******....*...***.....*..*****....***.....****************************************************************..........****     *.......*      **................**
******....**********..*...****.....*..*****......**...*****************************************************************..........****     *.......*      **....;;....;;....**
*******.************......****........................**************************************.....................******..........****     *.*...*.*      **...;!!;;;;!!;...**
*******.*************.....****........**********.*************************...........*******.....................................****     *.......*      **...;!!;;;;!!;...**
*******.*************.**********.***************.*************************...........*******.....................******..........****     *.*...*.*      **...;;;;;;;;;;...**
*******.****************************************.*************************...........*******.**************************..........****     *.......*      **..;;;;;;;;;;;;..**
*******.****************************************.****************************....***********.**************************..........****     *.*...*.*      **.;!!;;;;;;;;!!;.**
*****.....**************************************.************..**************....***********.****************************************     *.......*      **.;!!;;;;;;;;!!;.**
***........***************.**********..............******...........*********....***********.****************************************     *.*...*.*      **..;;;;;;;;;;;;..**
**...................*........*******.........*....******...........*********....***********.****************************************     *.......*      **...;!;;;;;;!;...**
***.........*******.......*...*******..............******...........******.....................**************************************     *.*...*.*      **....;;;;;;;;....**
***.......*********...........*******.......*..................................................**************************************     *.......*      *****..;!;;!;..*****
***.....***********.*..............................******...........******.....................**************************************     *.*...*.*      *****..;;;;;;..*****
******.************...........*******..*.........*.******...........******.....................**************************************     *.......*      *****..;!;;!;..*****
**********************.**************..............******...........******.....................**************************************     *.*...*.*      *****...;..;...*****
**************************************************************.**********************************************************************     *.......*      *******......*******
**************************************************************.**********************************************************************     *.*...*.*      *******......*******
**************************************************************.**********************************************************************     *.......*      *********..*********
**************************************************************.**********************************************************************     *.*...*.*      *********..*********
**************************************************************.**********************************************************************     *.......*      *********..*********
**************************************************************.**********************************************************************     *.*...*.*                          
**************************************************************.**********************************************************************     *.......*                          
**************************************************************.**********************************************************************     *.*...*.*                          
**************************************************************.*********************************************************...........**     *.......*                          
**************************************************************.*********************************************************...........**     *.*...*.*                          
**************************************************************.*********************************************************...........**     *.......*                          
****************************************************....................************************************************...........**     *.*...*.*                          
***********************************..............................................***************************************...........**     *.......*                          
***********************************.............****....................****........************************************...........**     *.*...*.*                          
***********************************.............*******...............*******.........***************************************.*******     *.......*                          
************..........*************.............*********...........**********..........*************************************.*******     *.*...*.*                          
************..........******....................***********.......*************.........*************************************.*******     *.......*                          
************..........******....................***********.*...*.*************..........************************************.*******     *.*...*.*                          
************....................................***********.......**************.............********************************.*******     *.......*                          
************..........******....................***********.*...*.**************..................***************************.*******     *.*...*.*                          
************..........******....................***********.......****************..................*************************.*******     *.......*                          
************..........*************.............***********.*...*.******************.................************************.*******     *.*...*.*                          
***********************************.............***********.......*********************..............************************.*******     *.......*                          
***********************************.............***********.*...*.*************************..........************************.*******     *.*...*.*                          
***********************************.............***********.......***************************........************************.*******     *.......*                          
**************************************************************.*******************************.........**********************.*******     *.*...*.*                          
**********************************************************************************************.................................******     *.......*                          
**********************************************************************************************................................*******     *.*...*.*                          
***********************************************************************************************...............................*******     *.......*                          
***********************************************************************************************..............................********     *.*...*.*                          
************************************************************************************************.............................********     *.......*                          
*************************************************************************************************........................************     *.*...*.*                          
*************************************************************************************************************************************     *.......*                          
*************************************************************************************************************************************     *********                          