                     *************************                     
                     *************************                     
                     *********.......*********                     
                     *******...........*******                     
                     ******.............******                     
                     *****...............*****                     
                     *****...............*****                     
                     ****.................****                     
                     ****.................****                     
                     ****.................****                     
                     ****.................****                     
                     ****.................****                     
                     ****.................****                     
                     *****...............*****                     
                     *****...............*****                     
                     ******.............******                     
                     *******...........*******                     
                     ********.........********                     
                     **********.....**********                     
                     ************.************                     
                     ************.************                     
  ******************************...******************************* 
  ******************************...******************************* 
  ******************************...******************************* 
  *******..............**********.***********..............******* 
  *****................**********.***********................***** 
  ****.................**..................**.................**** 
  ****........................................................**** 
  ***..................**..................**..................*** 
  ****.................**********************.................**** 
  *****................**********************................***** 
  ******...............**********************...............****** 
  ***********.***************************************.************ 
  ***********.***************************************.************ 
  **********...**************.........**************...*********** 
         ***...************.............************...***         
         ***...**********.................**********...***         
         ***...*********...................*********...***         
         ***...********.....................********...***         
         ***...*******.......................*******...***         
         ***...*******.......................*******...***         
         ***...******.........................******...***         
         ***...******.........................******...***         
 ***********...*****...........................*****...***         
 ************.******...........................******.************ 
 ************.******...........................******.************ 
 ***....**........**...........................**........**....*** 
 ***...........................................................*** 
 ***....**........**...........................**........**....*** 
 ***...*************...........................*************...*** 
 ***...*************...........................*************...*** 
 ***...**************.........................**************...*** 
 ***...***     ******.........................*****      ***...*** 
 ***...***     *******.......................******      ***...*** 
 ***...***           *.......................*           ***...*** 
 ***...***           **.....................**           ***...*** 
 ***...***           ***...................***           ***...*** 
 ****.****           ****.................****         ******.*****
*****.******         *****...............*****         ******.*****
****...*****         *******...........*******         *****...****
****...*****         *********.......*********         *****...****
***.....****         *************************         ****.....***
***......***         *************************         ***......***
***......***         *************************         ***......***
***.....****         *************************         ****.....***
***....*****   **************************************  *****....***
***....*****   *********....***********....**********  *****....***
***....*****   ******........*********........*******  *****....***
****....****   ****........*..*******..*........*****  ****....****
****....****   ***.............*****.............****  ****....****
*****....********.......*.......***.......*.......***  ***....*****
******....*******....*.....***...*...***.....*....*******....******
******....******..*..........***...***..........*..******....******
*******.....................................................*******
*********.................................................*********
****************..*..........***...***..........*..****************
*****************....*.....***.......***.....*....*****************
*****************.......*.................*.......*****************
               ***...............................****              
               ****........*...........*........*****              
               *****...........................******              
               *******.......*.......*.......********              
               **********.................***********              
               *************...*...*...**************              
                     *********.......*********                     
                     *********.*...*.*********                     
                     *********.......*********                     
                     *********.*...*.*********                     
                     *********.......*********                     
                     *********.*...*.*********                     
                     *********.......*********                     
                     *********.*...*.*********                     
                     *********.......*********                     
                     *************************                     
                     *************************                     
                     *************************                     