*******************************************************************
*******************************************************************
******************************.......******************************
****************************...........****************************
***************************.............***************************
**************************...............**************************
**************************...............**************************
*************************.................*************************
*************************.................*************************
*************************.................*************************
*************************.................*************************
*************************.................*************************
*************************.................*************************
**************************...............**************************
**************************...............**************************
***************************.............***************************
****************************...........****************************
*****************************.........*****************************
*******************************.....*******************************
*********************************.*********************************
*********************************.*********************************
********************************...********************************
********************************...********************************
********************************...********************************
*********..............**********.***********..............********
*******................**********.***********................******
******.................**..................**.................*****
******........................................................*****
*****..................**..................**..................****
******.................**********************.................*****
*******................**********************................******
********...............**********************...............*******
*************.***************************************.*************
*************.***************************************.*************
************...**************.........**************...************
************...************.............************...************
************...**********.................**********...************
************...*********...................*********...************
************...********.....................********...************
************...*******.......................*******...************
************...*******.......................*******...************
************...******.........................******...************
************...******.........................******...************
************...*****...........................*****...************
*************.******...........................******.*************
*************.******...........................******.*************
****....**........**...........................**........**....****
****...........................................................****
****....**........**...........................**........**....****
****...*************...........................*************...****
****...*************...........................*************...****
****...**************.........................**************...****
****...**************.........................**************...****
****...***************.......................***************...****
****...***************.......................***************...****
****...****************.....................****************...****
****...*****************...................*****************...****
*****.*******************.................*******************.*****
*****.********************...............********************.*****
****...*********************...........*********************...****
****...***********************.......***********************...****
***.....***************************************************.....***
***......*************************************************......***
***......*************************************************......***
***.....***************************************************.....***
***....*****************************************************....***
***....*****************....***********....*****************....***
***....**************........*********........**************....***
****....***********........*..*******..*........***********....****
****....**********.............*****.............**********....****
*****....********.......*.......***.......*.......********....*****
******....*******....*.....***...*...***.....*....*******....******
******....******..*..........***...***..........*..******....******
*******.....................................................*******
*********.................................................*********
****************..*..........***...***..........*..****************
*****************....*.....***.......***.....*....*****************
*****************.......*.................*.......*****************
******************...............................******************
*******************........*...........*........*******************
********************...........................********************
**********************.......*.......*.......**********************
*************************.................*************************
****************************...*...*...****************************
******************************.......******************************
******************************.*...*.******************************
******************************.......******************************
******************************.*...*.******************************
******************************.......******************************
******************************.*...*.******************************
******************************.......******************************
******************************.*...*.******************************
******************************.......******************************
*******************************************************************
*******************************************************************
*******************************************************************