 ************                                                                                                                      
 *..........*                                                                                                                      
 *..........*    *********                                                                                                         
 *..........*    *.......*    *************                                                                                        
 *..........*    *.......*    *...........*                                                                                        
 *..........*    *.......*    *...........*                                                                                        
 *..........*    *.......******...........*                                                                                        
 *..........*    *........................*                                                                                        
 *****.******    *.......******...........*                                                                                        
     *.*         ***.*****    *...........*                                                                                        
     *.*           *.*        ****.********                                                                                        
     *.*           *.*           *.*                                                                                               
   ***.*****    ****.****        *.*                                                                                               
   *.......******.......*  *******.**   *************                                                                              
   *....................*  *........*   *...........*                                                               ************   
   *.......******.......*  *........*   *...........*                                                               *..........*   
   *.......*    *.......*  *........*****...........*                                    ***********************    *..........*   
   **.******    *.......*  *........................*                  *************     *.....................******..........*   
    *.*         *.......*  *........**********.******                  *...........*     *.....................................*   
    *.*         *********  **********        *.*                       *...........*     *.....................******..........*   
    *.*                                      *.*                       *...........*     *.*********************    *..........*   
*****.*****                                  *.*                       ****....*****     *.*                        *..........*   
*.........*                       ************.***    *************       *....*         *.*                        ************   
*.........*******************     *..............*    *...........*       *....*         *.*                                       
*...........................*     *..............*    *...........*    ****....***********.***                                     
*.........*******...........*     *..............******...........******.....................*                                     
*.........*     *...........*******..........................................................*                                     
*.........*     *................................******...........******.....................*                                     
***********     *...........*******..............*    *...........*    *.....................*                                     
                *************     *..............*    *...........*    *.....................*                                     
                                  ****************    ******.******    ***********************                                     
                                                           *.*                                                                     
                                                           *.*                                                                     
                                                           *.*                                                                     
                                ****************************.***************************                                           
                                *..............................................*********                                           
                                *.................................................******                                           
         ************           *.............*******...............*******.........****                                           
         *..........*    ********.............*   *****...........*****   **..........**                              ************ 
         *..........*    *....................*   *******.......*******   ***.........***************                 *..........* 
         *..........******....................*         *.*...*.*         ***..........**************                 *..........* 
         *....................................*         *.......*         ****.............**********                 *..........* 
         *..........******....................*         *.*...*.*         ****..................*****                 *..........* 
         *..........*    *....................*         *.......*         ******..................***                 *..........* 
         *..........*    ********.............*         *.*...*.*         ********.................**                 *..........* 
         ************           *.............*         *.......*         ***********..............**                 *****..***** 
                                *.............*         *.*...*.*         ****************.........******************     *..*     
                                *.............*         *.......*         *****************........******************     *..*     
                                ***************         *********                        ***.........**********************..******
                                                                                         ***.................................******
                                                                                         ***................................*******
                                                                                         ****...............................*******
                                                                                         ****..............................********
                                                                                         *****.............................********
                                                                                         ******........................************
                                                                                         ******************************************
                                                                                         ******************************************