********************
*..................*
*..................*
*..................*
*..................*
*...*..............*
*..**.....##.......*
*.........##.......*
*..**..............*
*...*..............*
*..................*
*..................*
*..................*
*..................*
********************
