********************
*..................*
*..................*
*..................*
*..................*
*..................*
*.***..............*
*..................*
*..***.............*
*..................*
*..................*
*..................*
*..................*
*..................*
********************
