********************
*..................*
*..................*
*..................*
*..........%.......*
*...*.....%%%......*
*..**....%%%%%.....*
*.......%%%#%%%....*
*..**....%%%%%.....*
*...*.....%%%......*
*..........%.......*
*..................*
*..................*
*..................*
********************
