********************
*..................*
*..................*
*..........#.......*
*.........#%#......*
*...*....#%%%#.....*
*..**...#%%%%%#....*
*......#%%%#%%%#...*
*..**...#%%%%%#....*
*...*....#%%%#.....*
*.........#%#......*
*..........#.......*
*..................*
*..................*
********************
