********************
*..................*
*..................*
*..................*
*..................*
*...*..............*
*..**.....__.......*
*.........__.......*
*..**..............*
*...*..............*
*..................*
*..................*
*..................*
*..................*
********************
