********************
*..................*
*....R..........R..*
*...R............R.*
*..................*
*...*..............*
*..**..............*
*.R--......X.......*
*..**R.............*
*...*P.............*
*..................*
*...R............R.*
*....R..........R..*
*..................*
********************
