********************
*..................*
*..................*
*..................*
*..................*
*...*..............*
*..**..............*
*..................*
*..**..............*
*...*..............*
*..................*
*..................*
*..................*
*..................*
********************
