********************
*..................*
*....R..........R..*
*...R............R.*
*.......%%%%%%%....*
*..**...%%%%%%%....*
*..**...%%%%%%%....*
*.R--...%%%X%%%....*
*..***..%%%%%%%....*
*..**...%%%%%%%....*
*....R..%%%%%%%....*
*...RP...........R.*
*....R..........R..*
*..................*
********************
