********
**....**
**.*...*
*..*...*
*..***.*
*.**...*
*.....**
********