
     *******
 SS  *     *
 S-  * *** *
R--  * *X* *
 S-  * *** *
 SS  *     *
     *******