
    *******
SS  *     *
S-  * *** *
--  * *X* *
S-  * *** *
SS  *     *
    *******