----------------------
-********************-
-*.................*-
-*....***.....***...*-
-*....***....***....*-
-*....***...........*-
-*..................*-
-*...**..***........*-
-*...**..*-*........*-
-*.......***........*-
-*..................*-
-*..................*-
-*...**.**..........*-
-*...*---*..........*-
-*....---...........*-
-*...*---*..........*-
-*...**.**..........*-
-*..................*-
-*..................*-
-*..................*-
-*..................*-
-*..................*-
-********************-
----------------------
